NO ./img/cat1.xpm
SO ./img/exit.xpm
WE ./img/floor1.xpm
EA ./img/wall1.xpm

F 220,100,0
C 225,30,100

     11111111111
     1  11111111
  11     1     1
1111111110111111      
1000000100000001
1000000100000001
1100110000111011
1000000100000001
10000001000N0001
1111111111111111
