NO ./img/n.xpm
SO ./img/s.xpm
WE ./img/w.xpm
EA ./img/e.xpm

C 200,230,255   
F 140,192,122


1111111111111111111111111
1000000000110000000000001
1011000001110000000000001
1001000000000000000000001
1111111110110000011100001
1000000000110000011101111
1111011111111101110000001
1111011111111101110111101
110000001101010111001 101
10000000000000N0110011101
1000000000000000110101001
1100000111010101111101111
11110111 1110101 10111101
1111111111111111111111111