1111111111111111111111111
1000000000110000000000001
1011000001110000000000001
1001000000000000000000001
1111111110110000011100001
1000000000110000011101111
1111011111111101110000001
1111011111111101110111101
110000001101010111001 101
1000000000000000110011101
1000000000000000110101001
1100000111010101111101111
11110111 1110101 10111101
1111111111111111111111111