NO ./img/n.xpm
SO ./img/s.xpm
WE ./img/w.xpm
EA ./img/e.xpm

F 220,100,0
C 225,30,0


        1111111111111111111111111
        1000000000110000000000001
        1011000001110000000000001
        1001000000000000000000001
111111111011000001110000000000001
100000000011000001110111100111111
11110111111111011100000010001
11110111111111011101111010001
11000000110101011100111010001
10000000000000W01100101010001
10000000000000001101010010001
1100000111010101111101111000111
11110111 1110101 101111010001
11111111 11111111111111111111