NO ./img/cat1.xpm
SO ./img/exit.xpm
WE ./img/floor1.xpm
EA ./img/wall1.xpm

F 220,100,0
C 225,30,0


        1111111111111111111
        1000000011000000001
111111111000000111000011111
11110111 11101110010001
11110111W10101 10110001
11111111111111 11111111