NO ./img/n.xpm
SO ./img/s.xpm
WE ./img/w.xpm
EA ./img/e.xpm

F 220,100,0
C 225,30,100

11111111
11010001
10000001
10000001
10000001
100N0001
10000001
10000001
11111111
