NO ./img/n.xpm
SO ./img/s.xpm
WE ./img/w.xpm
EA ./img/e.xpm

F 220,100,0
C 225,30,100
11111111
1S010011
10000001
10000001
10000001
10000001
10000001
10000001
11111111
