NO ./img/NO.xpm
SO ./img/SO.xpm
WE ./img/WE.xpm
EA ./img/EA.xpm

F 220,100,0
C 225,30,100

111111
110101
100001
100001
100001
100N01
100001
100001
111111
