NO ./img/n.xpm
SO ./img/s.xpm
WE ./img/w.xpm
EA ./img/e.xpm

C 200,230,255   
F 140,192,122

111111
100001
100011
1001N1
111111
